,gender,Grade,parental level of education,lunch,test preparation course,math score,reading score,writing score,Total Marks
0,female, B,bachelor's degree,standard,none,72,72,74,218
1,female, C,some college,standard,completed,69,90,88,247
2,female, B,master's degree,standard,none,90,95,93,278
3,male, A,associate's degree,free/reduced,none,47,57,44,148
4,male, C,some college,standard,none,76,78,75,229
5,female, B,associate's degree,standard,none,71,83,78,232
6,female, B,some college,standard,completed,88,95,92,275
7,male, B,some college,free/reduced,none,40,43,39,122
8,male, D,high school,free/reduced,completed,64,64,67,195
9,female, B,high school,free/reduced,none,38,60,50,148
10,male, C,associate's degree,standard,none,58,54,52,164
11,male, D,associate's degree,standard,none,40,52,43,135
12,female, B,high school,standard,none,65,81,73,219
13,male, A,some college,standard,completed,78,72,70,220
14,female, A,master's degree,standard,none,50,53,58,161
15,female, C,some high school,standard,none,69,75,78,222
16,male, C,high school,standard,none,88,89,86,263
17,female, B,some high school,free/reduced,none,18,32,28,78
18,male, C,master's degree,free/reduced,completed,46,42,46,134
19,female, C,associate's degree,free/reduced,none,54,58,61,173
20,male, D,high school,standard,none,66,69,63,198
21,female, B,some college,free/reduced,completed,65,75,70,210
22,male, D,some college,standard,none,44,54,53,151
23,female, C,some high school,standard,none,69,73,73,215
24,male, D,bachelor's degree,free/reduced,completed,74,71,80,225
25,male, A,master's degree,free/reduced,none,73,74,72,219
26,male, B,some college,standard,none,69,54,55,178
27,female, C,bachelor's degree,standard,none,67,69,75,211
28,male, C,high school,standard,none,70,70,65,205
29,female, D,master's degree,standard,none,62,70,75,207
30,female, D,some college,standard,none,69,74,74,217
31,female, B,some college,standard,none,63,65,61,189
32,female, E,master's degree,free/reduced,none,56,72,65,193
33,male, D,some college,standard,none,40,42,38,120
34,male, E,some college,standard,none,97,87,82,266
35,male, E,associate's degree,standard,completed,81,81,79,241
36,female, D,associate's degree,standard,none,74,81,83,238
37,female, D,some high school,free/reduced,none,50,64,59,173
38,female, D,associate's degree,free/reduced,completed,75,90,88,253
39,male, B,associate's degree,free/reduced,none,57,56,57,170
40,male, C,associate's degree,free/reduced,none,55,61,54,170
41,female, C,associate's degree,standard,none,58,73,68,199
42,female, B,associate's degree,standard,none,53,58,65,176
43,male, B,some college,free/reduced,completed,59,65,66,190
44,female, E,associate's degree,free/reduced,none,50,56,54,160
45,male, B,associate's degree,standard,none,65,54,57,176
46,female, A,associate's degree,standard,completed,55,65,62,182
47,female, C,high school,standard,none,66,71,76,213
48,female, D,associate's degree,free/reduced,completed,57,74,76,207
49,male, C,high school,standard,completed,82,84,82,248
50,male, E,some college,standard,none,53,55,48,156
51,male, E,associate's degree,free/reduced,completed,77,69,68,214
52,male, C,some college,standard,none,53,44,42,139
53,male, D,high school,standard,none,88,78,75,241
54,female, C,some high school,free/reduced,completed,71,84,87,242
55,female, C,high school,free/reduced,none,33,41,43,117
56,female, E,associate's degree,standard,completed,82,85,86,253
57,male, D,associate's degree,standard,none,52,55,49,156
58,male, D,some college,standard,completed,58,59,58,175
59,female, C,some high school,free/reduced,none,0,17,10,27
60,male, E,bachelor's degree,free/reduced,completed,79,74,72,225
61,male, A,some high school,free/reduced,none,39,39,34,112
62,male, A,associate's degree,free/reduced,none,62,61,55,178
63,female, C,associate's degree,standard,none,69,80,71,220
64,female, D,some high school,standard,none,59,58,59,176
65,male, B,some high school,standard,none,67,64,61,192
66,male, D,some high school,free/reduced,none,45,37,37,119
67,female, C,some college,standard,none,60,72,74,206
68,male, B,associate's degree,free/reduced,none,61,58,56,175
69,female, C,associate's degree,standard,none,39,64,57,160
70,female, D,some college,free/reduced,completed,58,63,73,194
71,male, D,some college,standard,completed,63,55,63,181
72,female, A,associate's degree,free/reduced,none,41,51,48,140
73,male, C,some high school,free/reduced,none,61,57,56,174
74,male, C,some high school,standard,none,49,49,41,139
75,male, B,associate's degree,free/reduced,none,44,41,38,123
76,male, E,some high school,standard,none,30,26,22,78
77,male, A,bachelor's degree,standard,completed,80,78,81,239
78,female, D,some high school,standard,completed,61,74,72,207
79,female, E,master's degree,standard,none,62,68,68,198
80,female, B,associate's degree,standard,none,47,49,50,146
81,male, B,high school,free/reduced,none,49,45,45,139
82,male, A,some college,free/reduced,completed,50,47,54,151
83,male, E,associate's degree,standard,none,72,64,63,199
84,male, D,high school,free/reduced,none,42,39,34,115
85,female, C,some college,standard,none,73,80,82,235
86,female, C,some college,free/reduced,none,76,83,88,247
87,female, D,associate's degree,standard,none,71,71,74,216
88,female, A,some college,standard,none,58,70,67,195
89,female, D,some high school,standard,none,73,86,82,241
90,female, C,bachelor's degree,standard,none,65,72,74,211
91,male, C,high school,free/reduced,none,27,34,36,97
92,male, C,high school,standard,none,71,79,71,221
93,male, C,associate's degree,free/reduced,completed,43,45,50,138
94,female, B,some college,standard,none,79,86,92,257
95,male, C,associate's degree,free/reduced,completed,78,81,82,241
96,male, B,some high school,standard,completed,65,66,62,193
97,female, E,some college,standard,completed,63,72,70,205
98,female, D,some college,free/reduced,none,58,67,62,187
99,female, D,bachelor's degree,standard,none,65,67,62,194
100,male, B,some college,standard,none,79,67,67,213
101,male, D,bachelor's degree,standard,completed,68,74,74,216
102,female, D,associate's degree,standard,none,85,91,89,265
103,male, B,high school,standard,completed,60,44,47,151
104,male, C,some college,standard,completed,98,86,90,274
105,female, C,some college,standard,none,58,67,72,197
106,female, D,master's degree,standard,none,87,100,100,287
107,male, E,associate's degree,standard,completed,66,63,64,193
108,female, B,associate's degree,free/reduced,none,52,76,70,198
109,female, B,some high school,standard,none,70,64,72,206
110,female, D,associate's degree,free/reduced,completed,77,89,98,264
111,male, C,high school,standard,none,62,55,49,166
112,male, A,associate's degree,standard,none,54,53,47,154
113,female, D,some college,standard,none,51,58,54,163
114,female, E,bachelor's degree,standard,completed,99,100,100,299
115,male, C,high school,standard,none,84,77,74,235
116,female, B,bachelor's degree,free/reduced,none,75,85,82,242
117,female, D,bachelor's degree,standard,none,78,82,79,239
118,female, D,some high school,standard,none,51,63,61,175
119,female, C,some college,standard,none,55,69,65,189
120,female, C,bachelor's degree,standard,completed,79,92,89,260
121,male, B,associate's degree,standard,completed,91,89,92,272
122,female, C,some college,standard,completed,88,93,93,274
123,male, D,high school,free/reduced,none,63,57,56,176
124,male, E,some college,standard,none,83,80,73,236
125,female, B,high school,standard,none,87,95,86,268
126,male, B,some high school,standard,none,72,68,67,207
127,male, D,some college,standard,completed,65,77,74,216
128,male, D,master's degree,standard,none,82,82,74,238
129,female, A,bachelor's degree,standard,none,51,49,51,151
130,male, D,master's degree,standard,none,89,84,82,255
131,male, C,some high school,free/reduced,completed,53,37,40,130
132,male, E,some college,free/reduced,completed,87,74,70,231
133,female, C,some college,standard,completed,75,81,84,240
134,male, D,bachelor's degree,free/reduced,completed,74,79,75,228
135,male, C,bachelor's degree,standard,none,58,55,48,161
136,male, B,some high school,standard,completed,51,54,41,146
137,male, E,high school,standard,none,70,55,56,181
138,female, C,associate's degree,standard,none,59,66,67,192
139,male, D,some college,standard,completed,71,61,69,201
140,female, D,some high school,standard,none,76,72,71,219
141,female, C,some college,free/reduced,none,59,62,64,185
142,female, E,some college,free/reduced,completed,42,55,54,151
143,male, A,high school,standard,none,57,43,47,147
144,male, D,some college,standard,none,88,73,78,239
145,female, C,some college,free/reduced,none,22,39,33,94
146,male, B,some high school,standard,none,88,84,75,247
147,male, C,associate's degree,free/reduced,none,73,68,66,207
148,female, D,bachelor's degree,standard,completed,68,75,81,224
149,male, E,associate's degree,free/reduced,completed,100,100,93,293
150,male, A,some high school,standard,completed,62,67,69,198
151,male, A,bachelor's degree,standard,none,77,67,68,212
152,female, B,associate's degree,standard,completed,59,70,66,195
153,male, D,bachelor's degree,standard,none,54,49,47,150
154,male, D,some high school,standard,none,62,67,61,190
155,female, C,some college,standard,completed,70,89,88,247
156,female, E,high school,free/reduced,completed,66,74,78,218
157,male, B,some college,free/reduced,none,60,60,60,180
158,female, B,associate's degree,standard,completed,61,86,87,234
159,male, D,associate's degree,free/reduced,none,66,62,64,192
160,male, B,associate's degree,free/reduced,completed,82,78,74,234
161,female, E,some college,free/reduced,completed,75,88,85,248
162,male, B,master's degree,free/reduced,none,49,53,52,154
163,male, C,high school,standard,none,52,53,49,154
164,female, E,master's degree,standard,none,81,92,91,264
165,female, C,bachelor's degree,standard,completed,96,100,100,296
166,male, C,high school,free/reduced,completed,53,51,51,155
167,female, B,master's degree,free/reduced,completed,58,76,78,212
168,female, B,high school,standard,completed,68,83,78,229
169,female, C,some college,free/reduced,completed,67,75,70,212
170,male, A,high school,standard,completed,72,73,74,219
171,male, E,some high school,standard,none,94,88,78,260
172,female, D,some college,standard,none,79,86,81,246
173,female, C,associate's degree,standard,none,63,67,70,200
174,female, C,bachelor's degree,free/reduced,completed,43,51,54,148
175,female, C,master's degree,standard,completed,81,91,87,259
176,female, B,high school,free/reduced,completed,46,54,58,158
177,female, C,associate's degree,standard,completed,71,77,77,225
178,female, B,master's degree,free/reduced,completed,52,70,62,184
179,female, D,some high school,standard,completed,97,100,100,297
180,male, C,master's degree,free/reduced,completed,62,68,75,205
181,female, C,some college,free/reduced,none,46,64,66,176
182,female, E,high school,standard,none,50,50,47,147
183,female, D,associate's degree,standard,none,65,69,70,204
184,male, C,some high school,free/reduced,completed,45,52,49,146
185,male, C,associate's degree,free/reduced,completed,65,67,65,197
186,male, E,high school,standard,none,80,76,65,221
187,male, D,some high school,standard,completed,62,66,68,196
188,male, B,some high school,free/reduced,none,48,52,45,145
189,female, C,bachelor's degree,standard,none,77,88,87,252
190,female, E,associate's degree,standard,none,66,65,69,200
191,male, D,some college,standard,completed,76,83,79,238
192,female, B,some high school,standard,none,62,64,66,192
193,male, D,some college,standard,completed,77,62,62,201
194,female, C,master's degree,standard,completed,69,84,85,238
195,male, D,associate's degree,standard,none,61,55,52,168
196,male, C,some high school,free/reduced,completed,59,69,65,193
197,male, E,high school,free/reduced,none,55,56,51,162
198,female, B,some college,free/reduced,none,45,53,55,153
199,female, B,bachelor's degree,free/reduced,none,78,79,76,233
200,female, C,associate's degree,standard,completed,67,84,86,237
201,female, D,some college,free/reduced,none,65,81,77,223
202,male, C,associate's degree,standard,none,69,77,69,215
203,female, B,associate's degree,standard,none,57,69,68,194
204,male, C,some college,standard,none,59,41,42,142
205,male, D,some high school,standard,completed,74,71,78,223
206,male, E,bachelor's degree,standard,none,82,62,62,206
207,male, E,high school,standard,completed,81,80,76,237
208,female, B,some college,free/reduced,none,74,81,76,231
209,female, B,some college,free/reduced,none,58,61,66,185
210,male, D,some high school,free/reduced,completed,80,79,79,238
211,male, C,some college,free/reduced,none,35,28,27,90
212,female, C,high school,free/reduced,none,42,62,60,164
213,male, C,associate's degree,free/reduced,completed,60,51,56,167
214,male, E,high school,standard,completed,87,91,81,259
215,male, B,some high school,standard,completed,84,83,75,242
216,female, E,associate's degree,free/reduced,completed,83,86,88,257
217,female, C,high school,free/reduced,none,34,42,39,115
218,male, B,high school,free/reduced,none,66,77,70,213
219,male, B,some high school,standard,completed,61,56,56,173
220,female, D,high school,standard,completed,56,68,74,198
221,male, B,associate's degree,standard,none,87,85,73,245
222,female, C,some high school,free/reduced,none,55,65,62,182
223,male, D,some high school,standard,none,86,80,75,241
224,female, B,associate's degree,standard,completed,52,66,73,191
225,female, E,master's degree,free/reduced,none,45,56,54,155
226,female, C,some college,standard,none,72,72,71,215
227,male, D,high school,standard,none,57,50,54,161
228,male, A,some high school,free/reduced,none,68,72,64,204
229,female, C,some college,standard,completed,88,95,94,277
230,male, D,some college,standard,none,76,64,66,206
231,male, C,associate's degree,standard,none,46,43,42,131
232,female, B,bachelor's degree,standard,none,67,86,83,236
233,male, E,some high school,standard,none,92,87,78,257
234,male, C,bachelor's degree,standard,completed,83,82,84,249
235,male, D,associate's degree,standard,none,80,75,77,232
236,male, D,bachelor's degree,free/reduced,none,63,66,67,196
237,female, D,some high school,standard,completed,64,60,74,198
238,male, B,some college,standard,none,54,52,51,157
239,male, C,associate's degree,standard,none,84,80,80,244
240,male, D,high school,free/reduced,completed,73,68,66,207
241,female, E,bachelor's degree,standard,none,80,83,83,246
242,female, D,high school,standard,none,56,52,55,163
243,male, E,some college,standard,none,59,51,43,153
244,male, D,some high school,standard,none,75,74,69,218
245,male, C,associate's degree,standard,none,85,76,71,232
246,male, E,associate's degree,standard,none,89,76,74,239
247,female, B,high school,standard,completed,58,70,68,196
248,female, B,high school,standard,none,65,64,62,191
249,male, C,high school,standard,none,68,60,53,181
250,male, A,some high school,standard,completed,47,49,49,145
251,female, D,some college,free/reduced,none,71,83,83,237
252,female, B,some high school,standard,completed,60,70,70,200
253,male, D,master's degree,standard,none,80,80,72,232
254,male, D,high school,standard,none,54,52,52,158
255,female, E,some college,standard,none,62,73,70,205
256,female, C,associate's degree,free/reduced,none,64,73,68,205
257,male, C,associate's degree,standard,completed,78,77,77,232
258,female, B,some college,standard,none,70,75,78,223
259,female, C,master's degree,free/reduced,completed,65,81,81,227
260,female, C,some high school,free/reduced,completed,64,79,77,220
261,male, C,some college,standard,completed,79,79,78,236
262,female, C,some high school,free/reduced,none,44,50,51,145
263,female, E,high school,standard,none,99,93,90,282
264,male, D,high school,standard,none,76,73,68,217
265,male, D,some high school,free/reduced,none,59,42,41,142
266,female, C,bachelor's degree,standard,none,63,75,81,219
267,female, D,high school,standard,none,69,72,77,218
268,female, D,associate's degree,standard,completed,88,92,95,275
269,female, E,some college,free/reduced,none,71,76,70,217
270,male, C,bachelor's degree,standard,none,69,63,61,193
271,male, C,some college,standard,none,58,49,42,149
272,female, D,associate's degree,free/reduced,none,47,53,58,158
273,female, D,some college,standard,none,65,70,71,206
274,male, B,some college,standard,completed,88,85,76,249
275,male, C,bachelor's degree,standard,none,83,78,73,234
276,female, C,some high school,standard,completed,85,92,93,270
277,female, E,high school,standard,completed,59,63,75,197
278,female, C,some high school,free/reduced,none,65,86,80,231
279,male, B,bachelor's degree,free/reduced,none,73,56,57,186
280,male, D,high school,standard,none,53,52,42,147
281,male, D,high school,standard,none,45,48,46,139
282,female, D,bachelor's degree,free/reduced,none,73,79,84,236
283,female, D,some college,free/reduced,completed,70,78,78,226
284,female, B,some high school,standard,none,37,46,46,129
285,male, B,associate's degree,standard,completed,81,82,82,245
286,male, E,associate's degree,standard,completed,97,82,88,267
287,female, B,some high school,standard,none,67,89,82,238
288,male, B,bachelor's degree,free/reduced,none,88,75,76,239
289,male, E,some high school,standard,completed,77,76,77,230
290,male, C,associate's degree,standard,none,76,70,68,214
291,male, D,some high school,standard,none,86,73,70,229
292,male, C,some high school,standard,completed,63,60,57,180
293,female, E,bachelor's degree,standard,none,65,73,75,213
294,male, D,high school,free/reduced,completed,78,77,80,235
295,male, B,associate's degree,free/reduced,none,67,62,60,189
296,male, A,some high school,standard,completed,46,41,43,130
297,male, E,associate's degree,standard,completed,71,74,68,213
298,male, C,high school,free/reduced,completed,40,46,50,136
299,male, D,associate's degree,free/reduced,none,90,87,75,252
300,male, A,some college,free/reduced,completed,81,78,81,240
301,male, D,some high school,free/reduced,none,56,54,52,162
302,female, C,associate's degree,standard,completed,67,84,81,232
303,male, B,associate's degree,standard,none,80,76,64,220
304,female, C,associate's degree,standard,completed,74,75,83,232
305,male, A,some college,standard,none,69,67,69,205
306,male, E,some college,standard,completed,99,87,81,267
307,male, C,some high school,standard,none,51,52,44,147
308,female, B,associate's degree,free/reduced,none,53,71,67,191
309,female, D,high school,free/reduced,none,49,57,52,158
310,female, B,associate's degree,standard,none,73,76,80,229
311,male, B,bachelor's degree,standard,none,66,60,57,183
312,male, D,bachelor's degree,standard,completed,67,61,68,196
313,female, C,associate's degree,free/reduced,completed,68,67,69,204
314,female, C,bachelor's degree,standard,completed,59,64,75,198
315,male, C,high school,standard,none,71,66,65,202
316,female, D,master's degree,standard,completed,77,82,91,250
317,male, C,associate's degree,standard,none,83,72,78,233
318,male, B,bachelor's degree,standard,none,63,71,69,203
319,female, D,associate's degree,free/reduced,none,56,65,63,184
320,female, C,high school,free/reduced,completed,67,79,84,230
321,female, E,high school,standard,none,75,86,79,240
322,female, C,some college,standard,none,71,81,80,232
323,female, C,some high school,free/reduced,none,43,53,53,149
324,female, C,high school,free/reduced,none,41,46,43,130
325,female, C,some college,standard,none,82,90,94,266
326,male, C,some college,standard,none,61,61,62,184
327,male, A,some college,free/reduced,none,28,23,19,70
328,male, C,associate's degree,standard,completed,82,75,77,234
329,female, B,some high school,standard,none,41,55,51,147
330,male, C,high school,standard,none,71,60,61,192
331,male, C,associate's degree,standard,none,47,37,35,119
332,male, E,associate's degree,standard,completed,62,56,53,171
333,male, B,associate's degree,standard,none,90,78,81,249
334,female, C,bachelor's degree,standard,none,83,93,95,271
335,female, B,some college,free/reduced,none,61,68,66,195
336,male, D,some high school,standard,completed,76,70,69,215
337,male, C,associate's degree,standard,none,49,51,43,143
338,female, B,some high school,free/reduced,none,24,38,27,89
339,female, D,some high school,free/reduced,completed,35,55,60,150
340,male, C,high school,free/reduced,none,58,61,52,171
341,female, C,high school,standard,none,61,73,63,197
342,female, B,high school,standard,completed,69,76,74,219
343,male, D,associate's degree,standard,completed,67,72,67,206
344,male, D,some college,standard,none,79,73,67,219
345,female, C,high school,standard,none,72,80,75,227
346,male, B,some college,standard,none,62,61,57,180
347,female, C,bachelor's degree,standard,completed,77,94,95,266
348,male, D,high school,free/reduced,none,75,74,66,215
349,male, E,associate's degree,standard,none,87,74,76,237
350,female, B,bachelor's degree,standard,none,52,65,69,186
351,male, E,some college,standard,none,66,57,52,175
352,female, C,some college,standard,completed,63,78,80,221
353,female, C,associate's degree,standard,none,46,58,57,161
354,female, C,some college,standard,none,59,71,70,200
355,female, B,bachelor's degree,standard,none,61,72,70,203
356,male, A,associate's degree,standard,none,63,61,61,185
357,female, C,some college,free/reduced,completed,42,66,69,177
358,male, D,some college,free/reduced,none,59,62,61,182
359,female, D,some college,standard,none,80,90,89,259
360,female, B,high school,standard,none,58,62,59,179
361,male, B,some high school,standard,completed,85,84,78,247
362,female, C,some college,standard,none,52,58,58,168
363,female, D,some high school,free/reduced,none,27,34,32,93
364,male, C,some college,standard,none,59,60,58,177
365,male, A,bachelor's degree,free/reduced,completed,49,58,60,167
366,male, C,high school,standard,completed,69,58,53,180
367,male, C,bachelor's degree,free/reduced,none,61,66,61,188
368,female, A,some high school,free/reduced,none,44,64,58,166
369,female, D,some high school,standard,none,73,84,85,242
370,male, E,some college,standard,none,84,77,71,232
371,female, C,some college,free/reduced,completed,45,73,70,188
372,male, D,some high school,standard,none,74,74,72,220
373,female, D,some college,standard,completed,82,97,96,275
374,female, D,bachelor's degree,standard,none,59,70,73,202
375,male, E,associate's degree,free/reduced,none,46,43,41,130
376,female, D,some high school,standard,none,80,90,82,252
377,female, D,master's degree,free/reduced,completed,85,95,100,280
378,female, A,some high school,standard,none,71,83,77,231
379,male, A,bachelor's degree,standard,none,66,64,62,192
380,female, B,associate's degree,standard,none,80,86,83,249
381,male, C,associate's degree,standard,completed,87,100,95,282
382,male, C,master's degree,free/reduced,none,79,81,71,231
383,female, E,some high school,free/reduced,none,38,49,45,132
384,female, A,some high school,free/reduced,none,38,43,43,124
385,female, E,some college,standard,none,67,76,75,218
386,female, E,bachelor's degree,standard,none,64,73,70,207
387,female, C,associate's degree,free/reduced,none,57,78,67,202
388,female, D,high school,standard,none,62,64,64,190
389,male, D,master's degree,standard,none,73,70,75,218
390,male, E,some high school,free/reduced,completed,73,67,59,199
391,female, D,some college,standard,none,77,68,77,222
392,male, E,some college,standard,none,76,67,67,210
393,male, C,associate's degree,standard,completed,57,54,56,167
394,female, C,some high school,standard,completed,65,74,77,216
395,male, A,high school,free/reduced,none,48,45,41,134
396,female, B,high school,free/reduced,none,50,67,63,180
397,female, C,associate's degree,standard,none,85,89,95,269
398,male, B,some high school,standard,none,74,63,57,194
399,male, D,some high school,standard,none,60,59,54,173
400,female, C,some high school,standard,completed,59,54,67,180
401,male, A,some college,standard,none,53,43,43,139
402,female, A,some college,free/reduced,none,49,65,55,169
403,female, D,high school,standard,completed,88,99,100,287
404,female, C,high school,standard,none,54,59,62,175
405,female, C,some high school,standard,none,63,73,68,204
406,male, B,associate's degree,standard,completed,65,65,63,193
407,female, B,associate's degree,standard,none,82,80,77,239
408,female, D,high school,free/reduced,completed,52,57,56,165
409,male, D,associate's degree,standard,completed,87,84,85,256
410,female, D,master's degree,standard,completed,70,71,74,215
411,male, E,some college,standard,completed,84,83,78,245
412,male, D,associate's degree,standard,none,71,66,60,197
413,male, B,some high school,standard,completed,63,67,67,197
414,female, C,bachelor's degree,free/reduced,completed,51,72,79,202
415,male, E,high school,standard,none,84,73,69,226
416,male, C,bachelor's degree,standard,completed,71,74,68,213
417,male, C,associate's degree,standard,none,74,73,67,214
418,male, D,some college,standard,none,68,59,62,189
419,male, E,high school,free/reduced,completed,57,56,54,167
420,female, C,associate's degree,free/reduced,completed,82,93,93,268
421,female, D,high school,standard,completed,57,58,64,179
422,female, D,master's degree,free/reduced,completed,47,58,67,172
423,female, A,some high school,standard,completed,59,85,80,224
424,male, B,some college,free/reduced,none,41,39,34,114
425,female, C,some college,free/reduced,none,62,67,62,191
426,male, C,bachelor's degree,standard,none,86,83,86,255
427,male, C,some high school,free/reduced,none,69,71,65,205
428,male, A,some high school,free/reduced,none,65,59,53,177
429,male, C,some high school,free/reduced,none,68,63,54,185
430,male, C,associate's degree,free/reduced,none,64,66,59,189
431,female, C,high school,standard,none,61,72,70,203
432,male, C,high school,standard,none,61,56,55,172
433,female, A,some high school,free/reduced,none,47,59,50,156
434,male, C,some high school,standard,none,73,66,66,205
435,male, C,some college,free/reduced,completed,50,48,53,151
436,male, D,associate's degree,standard,none,75,68,64,207
437,male, D,associate's degree,free/reduced,none,75,66,73,214
438,male, C,high school,standard,none,70,56,51,177
439,male, D,some high school,standard,completed,89,88,82,259
440,female, C,some college,standard,completed,67,81,79,227
441,female, D,high school,standard,none,78,81,80,239
442,female, A,some high school,free/reduced,none,59,73,69,201
443,female, B,associate's degree,standard,none,73,83,76,232
444,male, A,some high school,free/reduced,none,79,82,73,234
445,female, C,some high school,standard,completed,67,74,77,218
446,male, D,some college,free/reduced,none,69,66,60,195
447,male, C,high school,standard,completed,86,81,80,247
448,male, B,high school,standard,none,47,46,42,135
449,male, B,associate's degree,standard,none,81,73,72,226
450,female, C,some college,free/reduced,completed,64,85,85,234
451,female, E,some college,standard,none,100,92,97,289
452,female, C,associate's degree,free/reduced,none,65,77,74,216
453,male, C,some college,free/reduced,none,65,58,49,172
454,female, C,associate's degree,free/reduced,none,53,61,62,176
455,male, C,bachelor's degree,free/reduced,none,37,56,47,140
456,female, D,bachelor's degree,standard,none,79,89,89,257
457,male, D,associate's degree,free/reduced,none,53,54,48,155
458,female, E,bachelor's degree,standard,none,100,100,100,300
459,male, B,high school,standard,completed,72,65,68,205
460,male, C,bachelor's degree,free/reduced,none,53,58,55,166
461,male, B,some college,free/reduced,none,54,54,45,153
462,female, E,some college,standard,none,71,70,76,217
463,female, C,some college,free/reduced,none,77,90,91,258
464,male, A,bachelor's degree,standard,completed,75,58,62,195
465,female, C,some college,standard,none,84,87,91,262
466,female, D,associate's degree,free/reduced,none,26,31,38,95
467,male, A,high school,free/reduced,completed,72,67,65,204
468,female, A,high school,free/reduced,completed,77,88,85,250
469,male, C,some college,standard,none,91,74,76,241
470,female, C,associate's degree,standard,completed,83,85,90,258
471,female, C,high school,standard,none,63,69,74,206
472,female, C,associate's degree,standard,completed,68,86,84,238
473,female, D,some high school,standard,none,59,67,61,187
474,female, B,associate's degree,standard,completed,90,90,91,271
475,female, D,bachelor's degree,standard,completed,71,76,83,230
476,male, E,bachelor's degree,standard,completed,76,62,66,204
477,male, D,associate's degree,standard,none,80,68,72,220
478,female, D,master's degree,standard,none,55,64,70,189
479,male, E,associate's degree,standard,none,76,71,67,214
480,male, B,high school,standard,completed,73,71,68,212
481,female, D,associate's degree,free/reduced,none,52,59,56,167
482,male, C,some college,free/reduced,none,68,68,61,197
483,male, A,high school,standard,none,59,52,46,157
484,female, B,associate's degree,standard,none,49,52,54,155
485,male, C,high school,standard,none,70,74,71,215
486,male, D,some college,free/reduced,none,61,47,56,164
487,female, C,associate's degree,free/reduced,none,60,75,74,209
488,male, B,some high school,standard,completed,64,53,57,174
489,male, A,associate's degree,free/reduced,completed,79,82,82,243
490,female, A,associate's degree,free/reduced,none,65,85,76,226
491,female, C,associate's degree,standard,none,64,64,70,198
492,female, C,some college,standard,none,83,83,90,256
493,female, C,bachelor's degree,standard,none,81,88,90,259
494,female, B,high school,standard,none,54,64,68,186
495,male, D,high school,standard,completed,68,64,66,198
496,female, C,some college,standard,none,54,48,52,154
497,female, D,some college,free/reduced,completed,59,78,76,213
498,female, B,some high school,standard,none,66,69,68,203
499,male, E,some college,standard,none,76,71,72,219
500,female, D,master's degree,standard,none,74,79,82,235
501,female, B,associate's degree,standard,completed,94,87,92,273
502,male, C,some college,free/reduced,none,63,61,54,178
503,female, E,associate's degree,standard,completed,95,89,92,276
504,female, D,master's degree,free/reduced,none,40,59,54,153
505,female, B,some high school,standard,none,82,82,80,244
506,male, A,high school,standard,none,68,70,66,204
507,male, B,bachelor's degree,free/reduced,none,55,59,54,168
508,male, C,master's degree,standard,none,79,78,77,234
509,female, C,bachelor's degree,standard,none,86,92,87,265
510,male, D,some college,standard,none,76,71,73,220
511,male, A,some high school,standard,none,64,50,43,157
512,male, D,some high school,free/reduced,none,62,49,52,163
513,female, B,some high school,standard,completed,54,61,62,177
514,female, B,master's degree,free/reduced,completed,77,97,94,268
515,female, C,some high school,standard,completed,76,87,85,248
516,female, D,some college,standard,none,74,89,84,247
517,female, E,some college,standard,completed,66,74,73,213
518,female, D,some high school,standard,completed,66,78,78,222
519,female, B,high school,free/reduced,completed,67,78,79,224
520,male, D,some college,standard,none,71,49,52,172
521,female, C,associate's degree,standard,none,91,86,84,261
522,male, D,bachelor's degree,standard,none,69,58,57,184
523,male, C,master's degree,free/reduced,none,54,59,50,163
524,male, C,high school,standard,completed,53,52,49,154
525,male, E,some college,standard,none,68,60,59,187
526,male, C,some high school,free/reduced,completed,56,61,60,177
527,female, C,high school,free/reduced,none,36,53,43,132
528,female, D,bachelor's degree,free/reduced,none,29,41,47,117
529,female, C,associate's degree,standard,none,62,74,70,206
530,female, C,associate's degree,standard,completed,68,67,73,208
531,female, C,some high school,standard,none,47,54,53,154
532,male, E,associate's degree,standard,completed,62,61,58,181
533,female, E,associate's degree,standard,completed,79,88,94,261
534,male, B,high school,standard,completed,73,69,68,210
535,female, C,bachelor's degree,free/reduced,completed,66,83,83,232
536,male, C,associate's degree,standard,completed,51,60,58,169
537,female, D,high school,standard,none,51,66,62,179
538,male, E,bachelor's degree,standard,completed,85,66,71,222
539,male, A,associate's degree,standard,completed,97,92,86,275
540,male, C,high school,standard,completed,75,69,68,212
541,male, D,associate's degree,free/reduced,completed,79,82,80,241
542,female, C,associate's degree,standard,none,81,77,79,237
543,female, D,associate's degree,standard,none,82,95,89,266
544,female, D,master's degree,standard,none,64,63,66,193
545,male, E,some high school,free/reduced,completed,78,83,80,241
546,female, A,some high school,standard,completed,92,100,97,289
547,male, C,high school,standard,completed,72,67,64,203
548,female, C,high school,free/reduced,none,62,67,64,193
549,male, C,master's degree,standard,none,79,72,69,220
550,male, C,some high school,free/reduced,none,79,76,65,220
551,male, B,bachelor's degree,free/reduced,completed,87,90,88,265
552,female, B,associate's degree,standard,none,40,48,50,138
553,male, D,some college,free/reduced,none,77,62,64,203
554,male, E,associate's degree,standard,none,53,45,40,138
555,female, C,some college,free/reduced,none,32,39,33,104
556,female, C,associate's degree,standard,completed,55,72,79,206
557,male, C,master's degree,free/reduced,none,61,67,66,194
558,female, B,associate's degree,free/reduced,none,53,70,70,193
559,male, D,some high school,standard,none,73,66,62,201
560,female, D,some college,standard,completed,74,75,79,228
561,female, C,some college,standard,none,63,74,74,211
562,male, C,bachelor's degree,standard,completed,96,90,92,278
563,female, D,some college,free/reduced,completed,63,80,80,223
564,male, B,bachelor's degree,free/reduced,none,48,51,46,145
565,male, B,associate's degree,standard,none,48,43,45,136
566,female, E,bachelor's degree,free/reduced,completed,92,100,100,292
567,female, D,master's degree,free/reduced,completed,61,71,78,210
568,male, B,high school,free/reduced,none,63,48,47,158
569,male, D,bachelor's degree,free/reduced,none,68,68,67,203
570,male, B,some college,standard,completed,71,75,70,216
571,male, A,bachelor's degree,standard,none,91,96,92,279
572,female, C,some college,standard,none,53,62,56,171
573,female, C,high school,free/reduced,completed,50,66,64,180
574,female, E,high school,standard,none,74,81,71,226
575,male, A,associate's degree,free/reduced,completed,40,55,53,148
576,male, A,some college,standard,completed,61,51,52,164
577,female, B,high school,standard,none,81,91,89,261
578,female, B,some college,free/reduced,completed,48,56,58,162
579,female, D,master's degree,standard,none,53,61,68,182
580,female, D,some high school,standard,none,81,97,96,274
581,female, E,some high school,standard,none,77,79,80,236
582,female, D,bachelor's degree,free/reduced,none,63,73,78,214
583,female, D,associate's degree,standard,completed,73,75,80,228
584,female, D,some college,standard,none,69,77,77,223
585,female, C,associate's degree,standard,none,65,76,76,217
586,female, A,high school,standard,none,55,73,73,201
587,female, C,bachelor's degree,free/reduced,none,44,63,62,169
588,female, C,some college,standard,none,54,64,65,183
589,female, A,some high school,standard,none,48,66,65,179
590,male, C,some college,free/reduced,none,58,57,54,169
591,male, A,some high school,standard,none,71,62,50,183
592,male, E,bachelor's degree,standard,none,68,68,64,200
593,female, E,high school,standard,none,74,76,73,223
594,female, C,bachelor's degree,standard,completed,92,100,99,291
595,female, C,bachelor's degree,standard,completed,56,79,72,207
596,male, B,high school,free/reduced,none,30,24,15,69
597,male, A,some high school,standard,none,53,54,48,155
598,female, D,high school,standard,none,69,77,73,219
599,female, D,some high school,standard,none,65,82,81,228
600,female, D,master's degree,standard,none,54,60,63,177
601,female, C,high school,standard,none,29,29,30,88
602,female, E,some college,standard,none,76,78,80,234
603,male, D,high school,free/reduced,none,60,57,51,168
604,male, D,master's degree,free/reduced,completed,84,89,90,263
605,male, C,some high school,standard,none,75,72,62,209
606,female, C,associate's degree,standard,none,85,84,82,251
607,female, C,master's degree,free/reduced,none,40,58,54,152
608,female, E,some college,standard,none,61,64,62,187
609,female, B,associate's degree,standard,none,58,63,65,186
610,male, D,some college,free/reduced,completed,69,60,63,192
611,female, C,some college,standard,none,58,59,66,183
612,male, C,bachelor's degree,standard,completed,94,90,91,275
613,female, C,associate's degree,standard,none,65,77,74,216
614,female, A,associate's degree,standard,none,82,93,93,268
615,female, C,high school,standard,none,60,68,72,200
616,female, E,bachelor's degree,standard,none,37,45,38,120
617,male, D,bachelor's degree,standard,none,88,78,83,249
618,male, D,master's degree,standard,none,95,81,84,260
619,male, C,associate's degree,free/reduced,completed,65,73,68,206
620,female, C,high school,free/reduced,none,35,61,54,150
621,male, B,bachelor's degree,free/reduced,none,62,63,56,181
622,male, C,high school,free/reduced,completed,58,51,52,161
623,male, A,some college,standard,completed,100,96,86,282
624,female, E,bachelor's degree,free/reduced,none,61,58,62,181
625,male, D,some college,standard,completed,100,97,99,296
626,male, B,associate's degree,free/reduced,completed,69,70,63,202
627,male, D,associate's degree,standard,none,61,48,46,155
628,male, D,some college,free/reduced,none,49,57,46,152
629,female, C,some high school,standard,completed,44,51,55,150
630,male, D,some college,standard,none,67,64,70,201
631,male, B,high school,standard,none,79,60,65,204
632,female, B,bachelor's degree,standard,completed,66,74,81,221
633,female, C,high school,standard,none,75,88,85,248
634,male, D,some high school,standard,none,84,84,80,248
635,male, A,high school,standard,none,71,74,64,209
636,female, B,high school,free/reduced,completed,67,80,81,228
637,female, D,some high school,standard,completed,80,92,88,260
638,male, E,some college,standard,none,86,76,74,236
639,female, D,associate's degree,standard,none,76,74,73,223
640,male, D,high school,standard,none,41,52,51,144
641,female, D,associate's degree,free/reduced,completed,74,88,90,252
642,female, B,some high school,free/reduced,none,72,81,79,232
643,female, E,high school,standard,completed,74,79,80,233
644,male, B,high school,standard,none,70,65,60,195
645,female, B,bachelor's degree,standard,completed,65,81,81,227
646,female, D,associate's degree,standard,none,59,70,65,194
647,female, E,high school,free/reduced,none,64,62,68,194
648,female, B,high school,standard,none,50,53,55,158
649,female, D,some college,standard,completed,69,79,81,229
650,male, C,some high school,free/reduced,completed,51,56,53,160
651,female, A,high school,standard,completed,68,80,76,224
652,female, D,some college,standard,completed,85,86,98,269
653,female, A,associate's degree,standard,completed,65,70,74,209
654,female, B,some high school,standard,none,73,79,79,231
655,female, B,some college,standard,none,62,67,67,196
656,male, C,associate's degree,free/reduced,none,77,67,64,208
657,male, D,some high school,standard,none,69,66,61,196
658,female, D,associate's degree,free/reduced,none,43,60,58,161
659,male, D,associate's degree,standard,none,90,87,85,262
660,male, C,some college,free/reduced,none,74,77,73,224
661,male, C,some high school,standard,none,73,66,63,202
662,female, D,some college,free/reduced,none,55,71,69,195
663,female, C,high school,standard,none,65,69,67,201
664,male, D,associate's degree,standard,none,80,63,63,206
665,female, C,some high school,free/reduced,completed,50,60,60,170
666,female, C,some college,free/reduced,completed,63,73,71,207
667,female, B,bachelor's degree,free/reduced,none,77,85,87,249
668,male, C,some college,standard,none,73,74,61,208
669,male, D,associate's degree,standard,completed,81,72,77,230
670,female, C,high school,free/reduced,none,66,76,68,210
671,male, D,associate's degree,free/reduced,none,52,57,50,159
672,female, C,some college,standard,none,69,78,76,223
673,female, C,associate's degree,standard,completed,65,84,84,233
674,female, D,high school,standard,completed,69,77,78,224
675,female, B,some college,standard,completed,50,64,66,180
676,female, E,some college,standard,completed,73,78,76,227
677,female, C,some high school,standard,completed,70,82,76,228
678,male, D,associate's degree,free/reduced,none,81,75,78,234
679,male, D,some college,free/reduced,none,63,61,60,184
680,female, D,high school,standard,none,67,72,74,213
681,male, B,high school,standard,none,60,68,60,188
682,male, B,high school,standard,none,62,55,54,171
683,female, C,some high school,free/reduced,completed,29,40,44,113
684,male, B,some college,standard,completed,62,66,68,196
685,female, E,master's degree,standard,completed,94,99,100,293
686,male, E,some college,standard,completed,85,75,68,228
687,male, D,associate's degree,free/reduced,none,77,78,73,228
688,male, A,high school,free/reduced,none,53,58,44,155
689,male, E,some college,free/reduced,none,93,90,83,266
690,female, C,associate's degree,standard,none,49,53,53,155
691,female, E,associate's degree,free/reduced,none,73,76,78,227
692,female, C,bachelor's degree,free/reduced,completed,66,74,81,221
693,female, D,associate's degree,standard,none,77,77,73,227
694,female, C,some high school,standard,none,49,63,56,168
695,female, D,some college,free/reduced,none,79,89,86,254
696,female, C,associate's degree,standard,completed,75,82,90,247
697,female, A,bachelor's degree,standard,none,59,72,70,201
698,female, D,associate's degree,standard,completed,57,78,79,214
699,male, C,high school,free/reduced,none,66,66,59,191
700,female, E,bachelor's degree,standard,completed,79,81,82,242
701,female, B,some high school,standard,none,57,67,72,196
702,male, A,bachelor's degree,standard,completed,87,84,87,258
703,female, D,some college,standard,none,63,64,67,194
704,female, B,some high school,free/reduced,completed,59,63,64,186
705,male, A,bachelor's degree,free/reduced,none,62,72,65,199
706,male, D,high school,standard,none,46,34,36,116
707,male, C,some college,standard,none,66,59,52,177
708,male, D,high school,standard,none,89,87,79,255
709,female, D,associate's degree,free/reduced,completed,42,61,58,161
710,male, C,some college,standard,completed,93,84,90,267
711,female, E,some high school,standard,completed,80,85,85,250
712,female, D,some college,standard,none,98,100,99,297
713,male, D,master's degree,standard,none,81,81,84,246
714,female, B,some high school,standard,completed,60,70,74,204
715,female, B,associate's degree,free/reduced,completed,76,94,87,257
716,male, C,associate's degree,standard,completed,73,78,72,223
717,female, C,associate's degree,standard,completed,96,96,99,291
718,female, C,high school,standard,none,76,76,74,226
719,male, E,associate's degree,free/reduced,completed,91,73,80,244
720,female, C,some college,free/reduced,none,62,72,70,204
721,male, D,some high school,free/reduced,completed,55,59,59,173
722,female, B,some high school,free/reduced,completed,74,90,88,252
723,male, C,high school,standard,none,50,48,42,140
724,male, B,some college,standard,none,47,43,41,131
725,male, E,some college,standard,completed,81,74,71,226
726,female, E,associate's degree,standard,completed,65,75,77,217
727,male, E,some high school,standard,completed,68,51,57,176
728,female, D,high school,free/reduced,none,73,92,84,249
729,male, C,some college,standard,none,53,39,37,129
730,female, B,associate's degree,free/reduced,completed,68,77,80,225
731,male, A,some high school,free/reduced,none,55,46,43,144
732,female, C,some college,standard,completed,87,89,94,270
733,male, D,some high school,standard,none,55,47,44,146
734,female, E,some college,free/reduced,none,53,58,57,168
735,male, C,master's degree,standard,none,67,57,59,183
736,male, C,associate's degree,standard,none,92,79,84,255
737,female, B,some college,free/reduced,completed,53,66,73,192
738,male, D,associate's degree,standard,none,81,71,73,225
739,male, C,high school,free/reduced,none,61,60,55,176
740,male, D,bachelor's degree,standard,none,80,73,72,225
741,female, A,associate's degree,free/reduced,none,37,57,56,150
742,female, C,high school,standard,none,81,84,82,247
743,female, C,associate's degree,standard,completed,59,73,72,204
744,male, B,some college,free/reduced,none,55,55,47,157
745,male, D,associate's degree,standard,none,72,79,74,225
746,male, D,high school,standard,none,69,75,71,215
747,male, C,some college,standard,none,69,64,68,201
748,female, C,bachelor's degree,free/reduced,none,50,60,59,169
749,male, B,some college,standard,completed,87,84,86,257
750,male, D,some high school,standard,completed,71,69,68,208
751,male, E,some college,standard,none,68,72,65,205
752,male, C,master's degree,free/reduced,completed,79,77,75,231
753,female, C,some high school,standard,completed,77,90,85,252
754,male, C,associate's degree,free/reduced,none,58,55,53,166
755,female, E,associate's degree,standard,none,84,95,92,271
756,male, D,some college,standard,none,55,58,52,165
757,male, E,bachelor's degree,free/reduced,completed,70,68,72,210
758,female, D,some college,free/reduced,completed,52,59,65,176
759,male, B,some college,standard,completed,69,77,77,223
760,female, C,high school,free/reduced,none,53,72,64,189
761,female, D,some high school,standard,none,48,58,54,160
762,male, D,some high school,standard,completed,78,81,86,245
763,female, B,high school,standard,none,62,62,63,187
764,male, D,some college,standard,none,60,63,59,182
765,female, B,high school,standard,none,74,72,72,218
766,female, C,high school,standard,completed,58,75,77,210
767,male, B,high school,standard,completed,76,62,60,198
768,female, D,some high school,standard,none,68,71,75,214
769,male, A,some college,free/reduced,none,58,60,57,175
770,male, B,high school,standard,none,52,48,49,149
771,male, D,bachelor's degree,standard,none,75,73,74,222
772,female, B,some high school,free/reduced,completed,52,67,72,191
773,female, C,bachelor's degree,free/reduced,none,62,78,79,219
774,male, B,some college,standard,none,66,65,60,191
775,female, B,some high school,free/reduced,none,49,58,55,162
776,female, B,high school,standard,none,66,72,70,208
777,female, C,some college,free/reduced,none,35,44,43,122
778,female, A,some college,standard,completed,72,79,82,233
779,male, E,associate's degree,standard,completed,94,85,82,261
780,female, D,associate's degree,free/reduced,none,46,56,57,159
781,female, B,master's degree,standard,none,77,90,84,251
782,female, B,high school,free/reduced,completed,76,85,82,243
783,female, C,associate's degree,standard,completed,52,59,62,173
784,male, C,bachelor's degree,standard,completed,91,81,79,251
785,female, B,some high school,standard,completed,32,51,44,127
786,female, E,some high school,free/reduced,none,72,79,77,228
787,female, B,some college,standard,none,19,38,32,89
788,male, C,associate's degree,free/reduced,none,68,65,61,194
789,female, C,master's degree,free/reduced,none,52,65,61,178
790,female, B,high school,standard,none,48,62,60,170
791,female, D,some college,free/reduced,none,60,66,70,196
792,male, D,high school,free/reduced,none,66,74,69,209
793,male, E,some high school,standard,completed,89,84,77,250
794,female, B,high school,standard,none,42,52,51,145
795,female, E,associate's degree,free/reduced,completed,57,68,73,198
796,male, D,high school,standard,none,70,70,70,210
797,female, E,associate's degree,free/reduced,none,70,84,81,235
798,male, E,some college,standard,none,69,60,54,183
799,female, C,associate's degree,standard,none,52,55,57,164
800,male, C,some high school,standard,completed,67,73,68,208
801,male, C,some high school,standard,completed,76,80,73,229
802,female, E,associate's degree,standard,none,87,94,95,276
803,female, B,some college,standard,none,82,85,87,254
804,female, C,some college,standard,none,73,76,78,227
805,male, A,some college,free/reduced,none,75,81,74,230
806,female, D,some college,free/reduced,none,64,74,75,213
807,female, E,high school,free/reduced,none,41,45,40,126
808,male, C,high school,standard,none,90,75,69,234
809,male, B,bachelor's degree,standard,none,59,54,51,164
810,male, A,some high school,standard,none,51,31,36,118
811,male, A,high school,free/reduced,none,45,47,49,141
812,female, C,master's degree,standard,completed,54,64,67,185
813,male, E,some high school,standard,completed,87,84,76,247
814,female, C,high school,standard,none,72,80,83,235
815,male, B,some high school,standard,completed,94,86,87,267
816,female, A,bachelor's degree,standard,none,45,59,64,168
817,male, D,bachelor's degree,free/reduced,completed,61,70,76,207
818,female, B,high school,free/reduced,none,60,72,68,200
819,female, C,some high school,standard,none,77,91,88,256
820,female, A,some high school,standard,completed,85,90,92,267
821,female, D,bachelor's degree,free/reduced,none,78,90,93,261
822,male, E,some college,free/reduced,completed,49,52,51,152
823,female, B,high school,free/reduced,none,71,87,82,240
824,female, C,some high school,free/reduced,none,48,58,52,158
825,male, C,high school,standard,none,62,67,58,187
826,female, C,associate's degree,free/reduced,completed,56,68,70,194
827,female, C,some high school,standard,none,65,69,76,210
828,female, D,some high school,free/reduced,completed,69,86,81,236
829,male, B,some high school,standard,none,68,54,53,175
830,female, A,some college,free/reduced,none,61,60,57,178
831,female, C,bachelor's degree,free/reduced,completed,74,86,89,249
832,male, A,bachelor's degree,standard,none,64,60,58,182
833,female, B,high school,standard,completed,77,82,89,248
834,male, B,some college,standard,none,58,50,45,153
835,female, C,high school,standard,completed,60,64,74,198
836,male, E,high school,standard,none,73,64,57,194
837,female, A,high school,standard,completed,75,82,79,236
838,male, B,associate's degree,free/reduced,completed,58,57,53,168
839,female, C,associate's degree,standard,none,66,77,73,216
840,female, D,high school,free/reduced,none,39,52,46,137
841,male, C,some high school,standard,none,64,58,51,173
842,female, B,high school,free/reduced,completed,23,44,36,103
843,male, B,some college,free/reduced,completed,74,77,76,227
844,female, D,some high school,free/reduced,completed,40,65,64,169
845,male, E,master's degree,standard,none,90,85,84,259
846,male, C,master's degree,standard,completed,91,85,85,261
847,male, D,high school,standard,none,64,54,50,168
848,female, C,high school,standard,none,59,72,68,199
849,male, D,associate's degree,standard,none,80,75,69,224
850,male, C,master's degree,standard,none,71,67,67,205
851,female, A,high school,standard,none,61,68,63,192
852,female, E,some college,standard,none,87,85,93,265
853,male, E,some high school,standard,none,82,67,61,210
854,male, C,some high school,standard,none,62,64,55,181
855,female, B,bachelor's degree,standard,none,97,97,96,290
856,male, B,some college,free/reduced,none,75,68,65,208
857,female, C,bachelor's degree,standard,none,65,79,81,225
858,male, B,high school,standard,completed,52,49,46,147
859,male, C,associate's degree,free/reduced,none,87,73,72,232
860,female, C,associate's degree,standard,none,53,62,53,168
861,female, E,master's degree,free/reduced,none,81,86,87,254
862,male, D,bachelor's degree,free/reduced,completed,39,42,38,119
863,female, C,some college,standard,completed,71,71,80,222
864,male, C,associate's degree,standard,none,97,93,91,281
865,male, D,some college,standard,completed,82,82,88,252
866,male, C,high school,free/reduced,none,59,53,52,164
867,male, B,associate's degree,standard,none,61,42,41,144
868,male, E,associate's degree,free/reduced,completed,78,74,72,224
869,male, C,associate's degree,free/reduced,none,49,51,51,151
870,male, B,high school,standard,none,59,58,47,164
871,female, C,some college,standard,completed,70,72,76,218
872,male, B,associate's degree,standard,completed,82,84,78,244
873,male, E,associate's degree,free/reduced,none,90,90,82,262
874,female, C,bachelor's degree,free/reduced,none,43,62,61,166
875,male, C,some college,free/reduced,none,80,64,66,210
876,male, D,some college,standard,none,81,82,84,247
877,male, C,some high school,standard,none,57,61,54,172
878,female, D,some high school,standard,none,59,72,80,211
879,female, D,associate's degree,standard,none,64,76,74,214
880,male, C,bachelor's degree,standard,completed,63,64,66,193
881,female, E,bachelor's degree,standard,completed,71,70,70,211
882,female, B,high school,free/reduced,none,64,73,71,208
883,male, D,bachelor's degree,free/reduced,none,55,46,44,145
884,female, E,associate's degree,standard,none,51,51,54,156
885,female, C,associate's degree,standard,completed,62,76,80,218
886,female, E,associate's degree,standard,completed,93,100,95,288
887,male, C,high school,free/reduced,none,54,72,59,185
888,female, D,some college,free/reduced,none,69,65,74,208
889,male, D,high school,free/reduced,none,44,51,48,143
890,female, E,some college,standard,completed,86,85,91,262
891,female, E,associate's degree,standard,none,85,92,85,262
892,female, A,master's degree,free/reduced,none,50,67,73,190
893,male, D,some high school,standard,completed,88,74,75,237
894,female, E,associate's degree,standard,none,59,62,69,190
895,female, E,some high school,free/reduced,none,32,34,38,104
896,male, B,high school,free/reduced,none,36,29,27,92
897,female, B,some high school,free/reduced,completed,63,78,79,220
898,male, D,associate's degree,standard,completed,67,54,63,184
899,female, D,some high school,standard,completed,65,78,82,225
900,male, D,master's degree,standard,none,85,84,89,258
901,female, C,master's degree,standard,none,73,78,74,225
902,female, A,high school,free/reduced,completed,34,48,41,123
903,female, D,bachelor's degree,free/reduced,completed,93,100,100,293
904,female, D,some high school,free/reduced,none,67,84,84,235
905,male, D,some college,standard,none,88,77,77,242
906,male, B,high school,standard,none,57,48,51,156
907,female, D,some college,standard,completed,79,84,91,254
908,female, C,bachelor's degree,free/reduced,none,67,75,72,214
909,male, E,bachelor's degree,standard,completed,70,64,70,204
910,male, D,bachelor's degree,free/reduced,none,50,42,48,140
911,female, A,some college,standard,none,69,84,82,235
912,female, C,bachelor's degree,standard,completed,52,61,66,179
913,female, C,bachelor's degree,free/reduced,completed,47,62,66,175
914,female, B,associate's degree,free/reduced,none,46,61,55,162
915,female, E,some college,standard,none,68,70,66,204
916,male, E,bachelor's degree,standard,completed,100,100,100,300
917,female, C,high school,standard,none,44,61,52,157
918,female, C,associate's degree,standard,completed,57,77,80,214
919,male, B,some college,standard,completed,91,96,91,278
920,male, D,high school,free/reduced,none,69,70,67,206
921,female, C,high school,free/reduced,none,35,53,46,134
922,male, D,high school,standard,none,72,66,66,204
923,female, B,associate's degree,free/reduced,none,54,65,65,184
924,male, D,high school,free/reduced,none,74,70,69,213
925,male, E,some high school,standard,completed,74,64,60,198
926,male, E,associate's degree,free/reduced,none,64,56,52,172
927,female, D,high school,free/reduced,completed,65,61,71,197
928,male, E,associate's degree,free/reduced,completed,46,43,44,133
929,female, C,some high school,free/reduced,none,48,56,51,155
930,male, C,some college,free/reduced,completed,67,74,70,211
931,male, D,some college,free/reduced,none,62,57,62,181
932,male, D,associate's degree,free/reduced,completed,61,71,73,205
933,male, C,bachelor's degree,free/reduced,completed,70,75,74,219
934,male, C,associate's degree,standard,completed,98,87,90,275
935,male, D,some college,free/reduced,none,70,63,58,191
936,male, A,associate's degree,standard,none,67,57,53,177
937,female, E,high school,free/reduced,none,57,58,57,172
938,male, D,some college,standard,completed,85,81,85,251
939,male, D,some high school,standard,completed,77,68,69,214
940,male, C,master's degree,free/reduced,completed,72,66,72,210
941,female, D,master's degree,standard,none,78,91,96,265
942,male, C,high school,standard,none,81,66,64,211
943,male, A,some high school,free/reduced,completed,61,62,61,184
944,female, B,high school,standard,none,58,68,61,187
945,female, C,associate's degree,standard,none,54,61,58,173
946,male, B,high school,standard,none,82,82,80,244
947,female, D,some college,free/reduced,none,49,58,60,167
948,male, B,some high school,free/reduced,completed,49,50,52,151
949,female, E,high school,free/reduced,completed,57,75,73,205
950,male, E,high school,standard,none,94,73,71,238
951,female, D,some college,standard,completed,75,77,83,235
952,female, E,some high school,free/reduced,none,74,74,72,220
953,male, C,high school,standard,completed,58,52,54,164
954,female, C,some college,standard,none,62,69,69,200
955,male, E,associate's degree,standard,none,72,57,62,191
956,male, C,some college,standard,none,84,87,81,252
957,female, D,master's degree,standard,none,92,100,100,292
958,female, D,high school,standard,none,45,63,59,167
959,male, C,high school,standard,none,75,81,71,227
960,female, A,some college,standard,none,56,58,64,178
961,female, D,some high school,free/reduced,none,48,54,53,155
962,female, E,associate's degree,standard,none,100,100,100,300
963,female, C,some high school,free/reduced,completed,65,76,75,216
964,male, D,some college,standard,none,72,57,58,187
965,female, D,some college,standard,none,62,70,72,204
966,male, A,some high school,standard,completed,66,68,64,198
967,male, C,some college,standard,none,63,63,60,186
968,female, E,associate's degree,standard,none,68,76,67,211
969,female, B,bachelor's degree,standard,none,75,84,80,239
970,female, D,bachelor's degree,standard,none,89,100,100,289
971,male, C,some high school,standard,completed,78,72,69,219
972,female, A,high school,free/reduced,completed,53,50,60,163
973,female, D,some college,free/reduced,none,49,65,61,175
974,female, A,some college,standard,none,54,63,67,184
975,female, C,some college,standard,completed,64,82,77,223
976,male, B,some college,free/reduced,completed,60,62,60,182
977,male, C,associate's degree,standard,none,62,65,58,185
978,male, D,high school,standard,completed,55,41,48,144
979,female, C,associate's degree,standard,none,91,95,94,280
980,female, B,high school,free/reduced,none,8,24,23,55
981,male, D,some high school,standard,none,81,78,78,237
982,male, B,some high school,standard,completed,79,85,86,250
983,female, A,some college,standard,completed,78,87,91,256
984,female, C,some high school,standard,none,74,75,82,231
985,male, A,high school,standard,none,57,51,54,162
986,female, C,associate's degree,standard,none,40,59,51,150
987,male, E,some high school,standard,completed,81,75,76,232
988,female, A,some high school,free/reduced,none,44,45,45,134
989,female, D,some college,free/reduced,completed,67,86,83,236
990,male, E,high school,free/reduced,completed,86,81,75,242
991,female, B,some high school,standard,completed,65,82,78,225
992,female, D,associate's degree,free/reduced,none,55,76,76,207
993,female, D,bachelor's degree,free/reduced,none,62,72,74,208
994,male, A,high school,standard,none,63,63,62,188
995,female, E,master's degree,standard,completed,88,99,95,282
996,male, C,high school,free/reduced,none,62,55,55,172
997,female, C,high school,free/reduced,completed,59,71,65,195
998,female, D,some college,standard,completed,68,78,77,223
999,female, D,some college,free/reduced,none,77,86,86,249
